3 2
2 2
8 7
00000000000000
2a800000002aa8
282a8000002aa8
2a828444442868
2aaaa911138038
2a802844428028
00000011100000
