1 5
14 5
14 2
40000000000000
38000000000000
00000000000000
28000000000000
28000000000000
28000000000000
28000000000000
28000000000000
00000000000000
