5 6
7 6
6 6
00444044400
06d550553c0
29155055438
2aa950553a8
2aaa9053aa8
02aaac3aa80
2aaac16aaa8
2aac5056aa8
2ac550556a8
2c555055568
01111011110
